....................
.......#............
...#...#...#...#....
...#...####....#....
...............###..
....................
#..........##.......
...........#........
...#................
...###..............
....................
....................
#..#.......##.###...
..........#.....#...
..#...#.........#...
..#.....#.......#...
..#.................
..#.......#..##.....
....#.....#...#.....
....................